{
  "playerStart": {"x": 10, "y": 10, "dir": "north"},
  "tiles": [
    "#####################",
    "#....##.......##....#",
    "#....##.......##....#",
    "#....##.......##....#",
    "#....##.......##....#",
    "#######.......#######",
    "#######.......#######",
    "#...................#",
    "#...................#",
    "#...................#",
    "#...................#",
    "#...................#",
    "#...................#",
    "#...................#",
    "#######.......#######",
    "#######.......#######",
    "#....##.......##....#",
    "#....##.......##....#",
    "#....##.......##....#",
    "#....##.......##....#",
    "#####################"
  ]
}
