{
  "playerStart": {"x": 4, "y": 7, "dir": "north"},
  "tiles": [
    "#########",
    "#.......#",
    "#.###.#.#",
    "#.#...#.#",
    "#.#.#.#.#",
    "#.#...#.#",
    "#.###.#.#",
    "#.......#",
    "#########"
  ]
}
