{
  "playerStart": {"x": 4, "y": 7, "z": 0.5, "dir": "north"},
  "tiles": [
    "#########",
    "#.......#",
    "#.###.#.#",
    "#.#...#.#",
    "#.#.#.#.#",
    "#.#...#.#",
    "#.###.#.#",
    "#.......#",
    "#########"
  ],
  "floors": [
    [0,0,0,0,0,0,0,0,0],
    [0,0,0,0,0,0,0,0,0],
    [0,0,0,0,0,0,0,0,0],
    [0,0,0,0,0,0,0,0,0],
    [0,0,0,0,0,0,0,0,0],
    [0,0,0,0,0,0,0,0,0],
    [0,0,0,0,0,0,0,0,0],
    [0,0,0,0,0,0,0,0,0],
    [0,0,0,0,0,0,0,0,0]
  ],
  "ceilings": [
    [2,2,2,2,2,2,2,2,2],
    [2,2,2,2,2,2,2,2,2],
    [2,2,2,2,2,2,2,2,2],
    [2,2,2,2,2,2,2,2,2],
    [2,2,2,2,2,2,2,2,2],
    [2,2,2,2,2,2,2,2,2],
    [2,2,2,2,2,2,2,2,2],
    [2,2,2,2,2,2,2,2,2],
    [2,2,2,2,2,2,2,2,2]
  ]
}
