{
  "playerStart": {"x": 1, "y": 1, "dir": "north"},
  "tiles": [
    "##########",
    "#........#",
    "#.######.#",
    "#........#",
    "##########"
  ]
}
